6 7
32 26 35 02 03 04
11 00 05 01 23 12
11 00 23 23 00 12
11 00 00 00 00 12
11 00 00 00 00 12
11 00 00 00 00 12
07 08 08 08 08 09
2 3 2
1 0
10
1 1 2 1 0 3 3 1
1 1 3 0 2 3 3 1
1 1 4 0 1 3 3 1
1 1 5 0 0 3 3 1
1 2 5 3 2 3 3 1
1 3 5 3 1 3 3 1
1 4 5 3 0 3 3 1
1 4 4 2 2 3 3 1
1 4 3 2 1 3 3 1
1 4 2 2 0 3 3 1
1
4 1