10 11
-1 -1 -1 -1 -1 -1 -1 32 26 35
02 03 03 03 03 03 03 01 00 12
11 23 23 23 23 23 23 23 00 12
11 00 00 00 00 14 15 16 00 12
11 00 00 00 00 23 23 23 00 12
11 18 20 18 18 18 18 18 18 12
11 17 21 22 22 22 22 22 17 12
11 17 19 19 19 19 19 21 17 12
11 36 36 36 36 36 36 36 36 12
11 00 10 08 08 08 08 08 08 09
33 27 34 -1 -1 -1 -1 -1 -1 -1
8 1 2
1 10
10
3 1 4 0 0 75 15
3 2 4 0 35 75 15
3 3 4 0 70 75 15
3 1 3 0 35 75 15
3 2 3 0 70 75 15
3 3 3 0 0 75 15
3 1 2 0 70 75 15
3 2 2 0 0 75 15
3 3 2 0 35 75 15
2 1 2 2 0 2 2 1
0
