19 6
32 26 35 -1 -1 -1 -1 02 03 04 -1 -1 -1 -1 -1 -1 -1 -1 -1
11 00 05 03 03 03 03 01 23 05 03 03 03 03 03 03 03 03 04
11 00 23 23 23 23 23 23 00 23 23 23 23 23 23 23 23 23 12
11 00 00 00 00 00 00 00 00 00 00 00 00 00 00 00 00 00 12
07 08 08 06 00 10 08 08 08 08 08 08 08 08 06 00 10 08 09
-1 -1 -1 07 08 09 -1 -1 -1 -1 -1 -1 -1 -1 07 08 09 -1 -1
1 1 2
1 0
4
0 1 2 1 0 8 2
0 1 3 1 0 8 2
0 9 2 1 0 8 2
0 9 3 1 0 8 2
2
17 2
17 3