8 10
32 26 35 -1 -1 -1 -1 -1
11 00 05 03 03 03 03 04
11 00 23 23 23 23 23 12
11 00 00 00 00 00 00 12
11 00 00 00 00 00 00 12
11 00 00 00 00 00 00 12
11 00 00 00 00 00 00 12
11 00 00 00 00 00 00 12
07 08 08 08 08 06 00 12
-1 -1 -1 -1 -1 33 27 34
1 1 2
6 9
9
1 1 2 1 0 1 1 0
1 3 2 1 0 1 1 0
1 5 2 1 0 1 1 0
1 1 4 1 0 1 1 0
1 3 4 1 0 1 1 0
1 5 4 1 0 1 1 0
1 1 6 1 0 1 1 0
1 3 6 1 0 1 1 0
1 5 6 1 0 1 1 0
0