9 7
-1 02 03 03 03 03 03 04 -1
28 01 23 23 23 23 23 12 -1
24 23 00 00 00 00 00 12 -1
30 06 00 00 00 00 00 05 29
-1 11 00 00 00 00 00 23 25
-1 11 00 00 00 00 00 10 31
-1 07 08 08 08 08 08 09 -1
1 2 1
8 4
5
0 2 1 2 0 4 1
0 3 5 0 0 4 1
0 4 1 2 0 4 1
0 5 5 0 0 4 1
0 6 1 2 0 4 1
5
2 5
3 4
4 3
5 2
6 1