10 7
-1 02 03 03 03 03 03 03 03 04
28 01 23 23 23 23 23 23 23 12
24 23 00 37 37 37 37 37 00 12
30 06 00 37 00 00 00 00 00 12
-1 11 00 37 37 37 37 37 00 12
-1 11 00 00 00 00 00 00 00 12
-1 07 08 08 08 08 08 08 08 09
1 2 1
0 2
5
3 7 3 0 0 60 60
2 2 1 2 0 6 4 2
2 8 1 3 0 6 4 2
2 2 5 1 0 6 4 2
2 8 5 0 0 6 4 2
1
4 3