10 8
-1 02 03 03 03 03 03 03 04 -1
-1 11 23 23 23 23 23 23 12 -1
28 01 00 00 00 00 00 00 05 29
24 23 00 00 00 00 00 00 23 25
30 06 00 00 00 00 00 00 10 31
-1 11 00 00 00 00 00 00 12 -1
-1 11 00 00 00 00 00 00 12 -1
-1 07 08 08 08 08 08 08 09 -1
1 3 1
9 3
12
0 2 1 2 0 2 2
0 3 1 2 0 2 2
0 4 1 2 0 2 2
0 5 1 2 0 2 2
0 6 1 2 0 2 2
0 7 1 2 0 2 2
0 2 4 2 0 2 2
0 3 4 2 0 2 2
0 4 4 2 0 2 2
0 5 4 2 0 2 2
0 6 4 2 0 2 2
0 7 4 2 0 2 2
0