14 17
-1 -1 02 03 03 03 03 03 03 04 -1 -1 -1 -1
-1 -1 11 23 23 23 23 23 23 12 -1 -1 -1 -1
-1 -1 11 00 00 00 00 00 00 12 -1 -1 -1 -1
-1 -1 11 00 00 00 00 00 00 12 -1 -1 -1 -1
-1 -1 07 06 00 10 08 06 00 12 -1 -1 -1 -1
-1 -1 -1 11 00 12 -1 11 00 05 03 03 03 04
-1 -1 -1 11 00 12 -1 11 00 23 23 23 23 12
02 03 03 01 00 05 04 11 20 18 18 18 18 12
11 23 23 23 00 23 12 11 21 22 22 22 22 12
11 00 14 15 16 00 12 11 19 19 19 19 21 12
11 00 23 23 23 00 12 11 22 22 22 22 21 12
11 00 14 15 16 00 12 11 21 19 19 19 19 12
11 00 23 23 23 00 12 11 36 36 36 36 36 12
07 06 00 10 08 08 09 07 08 08 08 06 00 12
-1 11 00 12 -1 -1 -1 -1 -1 -1 -1 11 00 12
-1 11 00 12 -1 -1 -1 -1 -1 -1 -1 33 27 34
-1 33 27 34 -1 -1 -1 -1 -1 -1 -1 -1 -1 -1
2 13 0
12 15
11
2 1 12 1 0 4 4 1
2 5 8 3 0 4 4 1
0 3 10 1 2 4 0
3 4 4 0 0 60 60
3 4 6 0 0 60 60
3 4 2 0 0 60 20
3 5 2 0 40 60 20
3 6 2 0 0 60 20
3 7 2 0 40 60 20
1 3 3 0 0 5 2 0
1 8 1 2 0 5 2 0
3
3 10 4 5 12 6
