13 9
-1 -1 -1 -1 -1 32 26 35 -1 -1 -1 -1 -1
02 03 03 03 03 01 00 05 03 03 03 03 04
11 23 23 23 23 23 00 23 23 23 23 23 12
11 00 00 00 00 00 00 00 00 00 00 00 12
11 00 00 00 00 00 00 00 00 00 00 00 12
11 00 00 00 00 00 00 00 00 00 00 00 12
11 00 00 00 00 00 00 00 00 00 00 00 12
07 08 08 08 08 06 00 10 08 08 08 08 09
-1 -1 -1 -1 -1 33 27 34 -1 -1 -1 -1 -1
6 1 2
6 8
5
0 1 2 1 0 10 0
0 1 3 1 0 10 0
0 1 4 1 0 10 0
0 1 5 1 0 10 0
0 1 6 1 0 10 0
8
2 3
4 3
8 3
10 3
2 5
4 5
8 5
10 5