17 6
32 26 35 -1 -1 -1 -1 -1 -1 -1 -1 -1 -1 -1 -1 -1 -1
11 00 05 03 03 03 03 03 03 03 03 03 03 03 03 03 04
11 00 23 23 23 23 23 23 23 23 23 23 23 23 23 23 12
11 00 00 00 00 00 00 00 00 00 00 00 00 00 00 00 12
07 08 08 08 08 08 08 08 08 08 08 08 08 08 06 00 12
-1 -1 -1 -1 -1 -1 -1 -1 -1 -1 -1 -1 -1 -1 33 27 34
1 1 2
15 5
6
0 1 2 1 0 4 1
0 5 3 3 0 4 1
0 6 3 1 0 4 1
0 10 2 3 0 4 1
0 11 2 1 0 4 1
0 15 3 3 0 4 1
0