9 12
-1 -1 -1 02 03 04 -1 -1 -1
-1 -1 02 01 23 05 04 -1 -1
-1 02 01 23 00 23 05 04 -1
-1 11 23 00 00 00 23 12 -1
28 01 00 00 00 00 00 05 29
24 23 00 00 00 00 00 23 25
30 06 00 00 00 00 00 10 31
-1 11 00 00 00 00 00 12 -1
-1 11 00 00 00 00 00 12 -1
-1 07 06 00 00 00 10 09 -1
-1 -1 07 06 00 10 09 -1 -1
-1 -1 -1 07 08 09 -1 -1 -1
1 5 1
8 5
10
0 2 3 2 0 2 0
0 2 6 2 0 2 0
0 3 2 2 0 3 1
0 3 6 2 0 3 1
0 4 1 2 0 4 2
0 4 6 2 0 4 2
0 5 2 2 0 3 0
0 5 6 2 0 3 0
0 6 3 2 0 2 2
0 6 6 2 0 2 2
0