11 7
-1 02 03 03 03 03 03 03 03 03 04
-1 11 23 23 23 23 23 23 23 23 12
28 01 00 00 00 00 00 00 00 00 12
24 23 00 00 00 00 00 00 00 00 12
30 06 00 00 00 00 00 00 00 00 12
-1 11 00 00 00 00 00 00 00 00 12
-1 07 08 08 08 08 08 08 08 08 09
1 3 1
0 3
10
3 2 1 0 0 100 20
3 2 2 0 60 100 20
3 2 3 0 0 100 20
3 2 4 0 60 100 20
3 2 5 0 0 100 20
0 3 1 1 0 6 2
0 3 2 1 0 6 2
0 3 3 1 0 6 2
0 3 4 1 0 6 2
0 3 5 1 0 6 2
5
7 1
7 2
7 3
7 4
7 5