10 12
-1 -1 -1 32 26 35 -1 -1 -1 -1
-1 -1 02 01 00 05 03 04 -1 -1
-1 -1 11 23 00 23 23 12 -1 -1
02 03 01 00 00 00 00 05 03 04
11 23 23 00 00 00 00 23 23 12
11 00 00 00 00 00 00 00 00 12
11 00 00 00 00 00 00 00 00 12
11 00 00 00 00 00 00 00 00 12
07 08 06 00 00 00 00 10 08 09
-1 -1 11 00 00 00 00 12 -1 -1
-1 -1 07 08 06 00 10 09 -1 -1
-1 -1 -1 -1 33 27 34 -1 -1 -1
4 1 2
5 11
8
0 3 2 2 0 7 2
0 5 2 2 0 7 2
0 4 9 0 0 7 2
0 6 9 0 0 7 2
0 1 5 1 0 7 2
0 1 7 1 0 7 2
0 8 4 3 0 7 2
0 8 6 3 0 7 2
4
1 4
5 5
4 6
8 7