11 11
-1 32 26 35 -1 -1 -1 -1 -1 -1 -1
02 01 00 05 04 -1 -1 -1 -1 -1 -1
11 23 00 23 05 04 -1 -1 -1 -1 -1
11 00 00 00 23 05 04 -1 -1 -1 -1
11 00 00 00 00 23 05 04 -1 -1 -1
07 06 00 00 00 00 23 05 04 -1 -1
-1 07 06 00 00 00 00 23 05 04 -1
-1 -1 07 06 00 00 00 00 23 05 29
-1 -1 -1 07 06 00 00 00 00 23 25
-1 -1 -1 -1 07 06 00 00 00 10 31
-1 -1 -1 -1 -1 07 08 08 08 09 -1
2 1 2
10 8
6
2 3 2 3 0 2 2 2
2 2 5 1 0 2 2 2
2 5 4 3 0 2 2 2
2 4 7 1 0 2 2 2
2 7 6 3 0 2 2 2
2 6 9 1 0 2 2 2
6
2 3
3 4
4 5
5 6
6 7
7 8