12 11
-1 -1 02 03 04 -1 -1 -1 -1 -1 -1 -1
-1 02 01 23 05 04 -1 -1 -1 -1 -1 -1
02 01 23 00 23 05 04 -1 -1 -1 -1 -1
11 23 00 00 00 23 05 04 -1 -1 -1 -1
07 06 00 00 00 00 23 05 04 -1 -1 -1
-1 07 06 00 00 00 00 23 05 04 -1 -1
-1 -1 07 06 00 00 00 00 23 05 04 -1
-1 -1 -1 07 06 00 00 00 00 23 05 29
-1 -1 -1 -1 07 06 00 00 00 00 23 25
-1 -1 -1 -1 -1 07 06 00 10 08 08 31
-1 -1 -1 -1 -1 -1 07 08 09 -1 -1 -1
2 2 1
11 8
10
0 1 3 1 0 4 0
0 6 4 3 0 4 0
0 3 5 1 0 4 0
0 8 6 3 0 4 0
0 5 7 1 0 4 0
0 3 1 2 0 4 0
0 4 6 0 0 4 0
0 5 3 2 0 4 0
0 6 8 0 0 4 0
0 7 5 2 0 4 0
2
4 6
6 4