10 10
02 03 03 03 03 03 03 03 03 04
11 23 23 23 23 23 23 23 23 12
11 00 00 00 00 00 00 00 00 12
11 00 00 00 00 00 00 00 00 12
11 00 00 00 00 00 00 00 00 12
11 00 00 00 00 00 00 00 00 12
11 00 00 00 00 00 00 00 00 12
11 00 00 00 00 00 00 00 00 12
11 00 00 00 00 00 00 00 00 12
07 08 08 08 08 08 08 08 08 09
1 1 2
10 9
8
2 4 4 2 0 3 3 0
2 6 4 3 0 3 3 0
2 6 6 0 0 3 3 0
2 4 6 1 0 3 3 0
2 3 3 2 0 5 5 0
2 7 3 3 0 5 5 0
2 7 7 0 0 5 5 0
2 3 7 1 0 5 5 0
0

2 4 4 2 0 2 2 0
2 5 4 3 0 2 2 0
2 5 5 0 0 2 2 0
2 4 5 1 0 2 2 0
2 3 3 2 0 4 4 0
2 6 3 3 0 4 4 0
2 6 6 0 0 4 4 0
2 3 6 1 0 4 4 0

2 3 3 2 0 4 4 1
2 6 3 3 0 4 4 1
2 6 6 0 0 4 4 1
2 3 6 1 0 4 4 1
2 2 2 2 0 6 6 1
2 7 2 3 0 6 6 1
2 7 7 0 0 6 6 1
2 2 7 1 0 6 6 1