10 10
02 03 03 03 03 03 03 03 03 04
11 23 23 23 23 23 23 23 23 12
11 00 00 00 00 00 00 00 00 12
11 00 00 00 00 00 00 00 00 12
11 00 00 00 00 00 00 00 00 12
11 00 00 00 00 00 00 00 00 12
11 00 00 00 00 00 00 00 00 12
11 00 00 00 00 00 00 00 00 12
11 00 00 00 00 00 00 00 00 12
07 08 08 08 08 08 08 08 08 09
5 1 2
8 8
10
2 3 3 2 0 4 4 1
2 6 3 3 0 4 4 1
2 6 6 0 0 4 4 1
2 3 6 1 0 4 4 1
0 4 1 2 0 7 0
0 1 5 1 0 7 0
0 8 4 3 0 7 0
0 5 8 0 0 7 0
1 1 1 1 0 7 7 0
1 8 8 3 0 7 7 0
0